11
11
PPPPPPPPPPP
PPPPPPPPPPP
PPPPPPPPPPP
PPPKSSAPPPP
PPPPSPAPPPP
PPPPSPAPPPP
PPPPPPAPPPP
PPPPPPAPPPP
PPPPPPPPPPP
PPPPPPPPPPP
PPPPPPPPPPP
