11
11
PPPPPPPPPPP
PPPPPPPPPPP
PPPPPPPPPPP
PPPPKPPPPPP
PPPDSSAPPPP
PPPPSPAPPPP
PPPPSPAPPPP
PPPPPPAPPPP
PPPPPPPPPPP
PPPPPPPPPPP
PPPPPPPPPPP
